ctrl-d=debugenter
ctrl-s=mouseenter
d=dumpeng
shift-d=dumpsec
e=edges
c=clear
ctrl-shift-c=colorsectors
alt-c=cacheclear
alt-d=cachedump
t=texture
l=lighting
shift-g=gouraud
shift-m=mmx
shift-t=transp
ctrl-b=bilinear
ctrl-t=trilinear
ctrl-l=ilace
m=mipmap
shift-i=inter
g=gamma
alt-b=dblbuff
shift-c=dumpcam
f=fov
shift-f=fovangle
alt-t=terrvis
b=meshbbox
r=meshrad
ctrl-alt-c=meshcd
ctrl-alt-v=meshvis
ctrl-alt-s=meshshad
ctrl-alt-b=meshbase
ctrl-g=debuggraph
ctrl-c=enginecmd toggle_cullstat
shift-e=enginestate
v=visculview
shift-v=visculcmd cycle_view
ctrl-v=visculcmd clear_stats
alt-v=visculcmd dump_state
alt-a=visculcmd analyze_vis
1=visculcmd toggle_frustum
2=visculcmd toggle_coverage
3=visculcmd toggle_history
4=visculcmd toggle_queue
5=visculcmd toggle_vpt
6=visculcmd toggle_ignoresmall
7=visculcmd toggle_clampoccluder
8=visculcmd toggle_splatting
9=visculcmd toggle_invertedclipper
0=visculcmd toggle_ignorebadoccluder
shift-1=visculcmd origin_z --
shift-2=visculcmd origin_z ++
shift-3=visculcmd setup_debugsector
shift-4=visculcmd navigate_child1
shift-5=visculcmd navigate_child2
shift-6=visculcmd navigate_parent
shift-s=debugsector
shift-up=mesh_yplus
shift-down=mesh_ymin
shift-left=mesh_xmin
shift-right=mesh_xplus
shift-pgup=mesh_zplus
shift-pgdn=mesh_zmin
up=ds_forward
down=ds_backward
left=ds_turnleft
right=ds_turnright
alt-up=ds_up
alt-down=ds_down
alt-left=ds_left
alt-right=ds_right
alt-s=debugview
s=visculcmd setup_debugview
alt-f=visculcmd toggle_freeze
ctrl-f=visculcmd exact_freeze
f10=savemap
f11=scrshot
f12=scrshot
ctrl-alt-p=fps
h=hideselected
shift-h=undohide
ctrl-p=counterreset
alt-p=counterremove
shift-p=counterfreeze
w=shadowdebug
alt-u=unprepare
ctrl-m=memorydump
p=profdump
ctrl-shift-p=profreset

ctrl-shift-s=debugcmd iGraphics3D dump_slms
ctrl-shift-v=debugcmd iGraphics3D dump_vbostat
ctrl-shift-f=debugcmd iGraphics2D dump_fontcache
ctrl-shift-z=debugcmd iGraphics3D dump_zbuf
ctrl-shift-1=switchculler crystalspace.culling.frustvis
ctrl-shift-2=switchculler crystalspace.culling.dynavis
ctrl-alt-m=selectmesh
ctrl-alt-o=onesector
ctrl-alt-p=listplugins

